8 8
++++
+  +
+  +++++
+      +
++ *+# +
+   +  +
+   ++++
+++++