8 8
++++
+  +
+  +++++
+      +
++ M+  +
+ # +O +
+   ++++
+++++