6 8
++++++++
+  **  +
+  **  +
+   W  +
+  ####+
++++++++