30 7
+     +  +++++  +    +  +   +
+     +    +    ++   +  +   +
 +   +     +    + +  +  +   +
 +   +     +    + +  +  +++++
  + +  *W  +    +  + +  +   +
  + +   #  +    +  + +  +   +
   +     +++++  +   ++  +   +